41 41 41 41 41 41 41 41 41 41 41 41 41 41 41 41 41 41 41 41 41 41 41 41 41 41 41 41 41 41 41 41 41 41 41 41 41 41 41 41 41 41 41 41 41 41 41 41 41 41 41 41 41 41 41 41 41 41 41 41 41 41 41 41 41 41 41 41 41 41 41 41 41 41 41 41 41 41 41 41 41 41 41 41 41 41 41 41 41 41 41 41 41 41 41 41 41 41 41 41 
41 41 41 41 41 41 41 41 41 41 41 41 41 41 41 41 41 41 41 41 41 41 41 41 41 41 41 41 41 41 41 41 41 41 41 41 41 41 41 41 41 41 41 41 41 41 41 41 41 41 41 41 41 41 41 41 41 41 41 41 41 41 41 41 41 41 41 41 41 41 41 41 41 41 41 41 41 41 41 41 41 41 41 41 41 41 41 41 41 41 41 41 41 41 41 41 41 41 41 41 
41 41 41 41 41 10 10 10 10 10 10 10 10 10 10 10 10 10 10 10 10 10 10 10 10 10 10 41 41 41 41 41 41 41 41 41 41 41 41 41 40 40 40 40 40 40 40 40 40 40 40 40 40 40 40 40 40 40 40 40 41 41 41 41 41 40 40 40 40 40 40 40 40 40 40 40 40 40 40 40 40 40 40 40 40 40 40 40 40 40 40 40 40 40 40 41 41 41 41 41 
41 41 41 41 10 10 10 10 10 10 10 10 10 10 10 10 10 10 10 10 10 10 10 10 10 10 10 10 41 41 41 41 41 41 41 41 41 41 41 41 40 39 39 39 39 39 39 39 39 39 39 39 39 39 39 39 39 39 39 40 41 41 41 41 41 40 10 10 10 10 10 10 10 10 10 10 10 10 10 10 10 10 10 10 10 10 10 10 10 10 10 10 10 10 40 41 41 41 41 41 
41 41 41 10 10 10 10 10 10 10 10 10 10 10 10 10 10 10 10 10 10 10 10 10 10 10 10 10 10 41 41 41 41 41 41 41 41 41 41 41 40 39 39 39 39 39 39 39 39 39 39 39 39 39 39 39 39 39 39 40 41 41 41 41 41 40 10 10 42 10 10 42 10 10 42 10 10 42 10 10 42 10 10 42 10 10 42 10 10 42 10 10 42 10 40 41 41 41 41 41 
41 41 41 10 10 10 10 10 12 12 12 12 12 12 12 12 12 12 12 12 12 12 12 10 10 10 10 10 10 41 41 41 41 41 41 41 41 41 41 41 40 39 39 39 39 39 39 39 39 39 39 39 39 39 39 39 39 39 39 40 41 41 41 41 41 40 10 10 10 35 33 33 33 33 33 33 33 33 33 33 33 33 33 33 33 33 33 33 33 10 10 10 10 10 40 41 41 41 41 41 
41 41 41 10 10 10 10 12 12 12 12 12 12 12 12 12 12 12 12 12 12 12 12 12 10 10 10 10 10 41 41 41 41 41 41 41 41 41 41 41 40 39 39 39 39 39 39 39 39 39 39 39 39 39 39 39 39 39 39 40 41 41 41 41 41 40 10 42 10 31 26 26 26 26 26 26 26 26 26 26 26 26 26 26 26 26 26 26 26 30 10 42 10 10 40 41 41 41 41 41 
41 41 41 10 10 10 12 12 12 12 12 12 12 12 12 12 12 12 12 12 12 12 12 12 12 10 10 10 10 41 41 41 41 41 41 41 41 41 41 41 40 39 39 39 39 39 39 39 39 39 39 39 39 39 39 39 39 39 39 40 41 41 41 41 41 40 10 10 10 31 26 26 26 26 26 26 26 26 26 26 26 26 26 26 26 26 26 26 26 30 10 10 10 10 40 41 41 41 41 41 
41 41 41 10 10 10 12 12 12 12 12 12 12 12 12 12 12 12 12 12 12 12 12 12 12 12 10 10 10 10 41 41 41 41 41 41 41 41 41 41 40 39 39 39 39 39 39 39 39 39 39 39 39 39 39 39 39 39 39 40 41 41 41 41 41 40 10 10 42 31 26 26 10 10 10 10 10 10 10 10 10 10 10 10 10 10 10 26 26 30 10 10 42 10 40 41 41 41 41 41 
41 41 41 10 10 10 12 12 12 12 12 12 12 12 12 12 12 12 12 12 12 12 12 12 12 12 10 10 10 10 10 10 10 10 41 41 41 41 41 41 40 39 39 39 39 39 39 39 39 39 39 39 39 39 39 39 39 39 39 40 41 41 41 41 41 40 10 10 10 31 26 26 10 10 42 10 10 42 10 10 42 10 10 42 10 10 31 26 26 30 10 10 10 10 40 41 41 41 41 41 
41 41 41 10 10 10 12 12 12 12 12 12 12 12 12 12 12 12 12 12 12 12 12 12 12 12 10 10 10 10 10 10 10 10 10 41 41 41 41 41 40 39 39 39 39 39 39 39 39 39 39 39 39 39 39 39 39 39 39 40 41 41 41 41 41 40 10 35 33 10 26 26 10 33 10 10 10 10 10 10 10 10 10 10 10 10 31 26 26 30 10 42 10 10 40 41 41 41 41 41 
41 41 41 10 10 10 12 12 12 12 12 12 12 12 12 12 12 12 12 12 12 12 12 12 12 12 12 10 10 10 10 10 10 10 10 10 41 10 41 41 40 39 39 39 39 39 39 39 39 39 39 39 39 39 39 39 39 39 39 40 41 41 10 41 41 40 10 31 26 26 26 26 26 26 30 10 10 10 10 10 10 10 10 10 10 10 31 26 26 30 10 10 10 10 40 41 41 41 41 41 
41 41 41 10 10 10 12 12 12 12 12 12 12 12 12 12 12 12 12 12 12 12 12 12 12 12 12 12 12 12 12 10 10 10 10 10 10 41 41 41 40 39 39 39 39 39 39 39 39 39 39 39 39 39 39 39 39 39 39 40 41 10 10 10 41 40 10 31 26 26 26 26 26 26 30 10 10 42 10 10 42 10 10 42 10 10 31 26 26 30 10 10 42 10 40 41 41 41 41 41 
41 41 41 10 10 10 10 12 12 12 12 12 12 12 12 12 12 12 12 12 12 12 12 12 12 12 12 12 12 12 12 12 10 10 10 10 10 10 41 41 40 39 39 39 39 39 39 39 39 39 39 39 39 39 39 39 39 39 39 40 41 10 10 10 41 40 10 31 26 26 26 26 26 26 30 10 10 10 10 10 10 10 10 10 10 10 31 26 26 30 10 10 10 10 40 41 41 41 41 41 
41 41 41 10 10 10 10 10 12 12 12 12 12 12 12 12 12 12 12 12 12 12 12 12 12 12 12 12 12 12 12 12 10 10 10 10 10 10 10 41 40 39 39 39 39 39 39 39 39 39 39 39 39 39 39 39 39 39 39 40 10 10 10 10 10 40 10 31 26 26 26 26 26 26 30 10 10 10 10 10 10 10 10 10 10 10 31 26 26 30 10 42 10 10 40 41 41 41 41 41 
41 41 41 10 10 10 10 10 10 10 10 10 12 12 12 12 12 12 12 12 12 12 12 12 12 12 12 12 12 12 12 12 10 10 10 10 10 10 10 10 40 40 40 40 40 40 40 40 40 39 39 40 40 40 40 40 40 40 40 40 10 10 10 10 10 40 10 31 26 26 26 26 26 26 30 10 10 42 10 10 42 10 10 42 10 10 31 26 26 30 10 10 10 10 40 41 41 41 41 41 
41 41 41 10 10 10 10 10 10 10 10 10 10 12 12 12 12 12 12 12 12 12 12 12 12 12 12 12 12 12 12 12 10 10 10 10 10 10 10 10 10 10 10 10 10 10 10 10 31 26 26 30 10 10 10 10 10 10 10 10 10 10 10 10 10 40 10 10 28 28 28 28 28 28 10 10 10 10 10 10 10 10 10 10 10 10 31 26 26 30 10 10 42 10 40 41 41 41 41 41 
41 41 41 10 10 10 35 33 33 33 10 10 10 10 10 12 12 12 12 12 12 12 12 12 12 12 12 12 12 12 12 10 10 10 10 10 10 10 10 10 10 10 10 10 10 10 10 10 31 26 26 30 10 10 10 10 10 10 10 10 10 10 10 10 10 40 10 10 10 10 10 10 10 10 10 10 10 10 10 10 10 10 10 10 10 10 31 26 26 30 10 10 10 10 40 41 41 41 41 41 
41 41 41 10 10 10 31 26 26 26 30 10 10 10 10 10 10 10 10 10 10 10 10 10 10 10 10 10 10 10 10 10 10 10 10 10 10 10 10 10 10 10 10 10 10 10 10 10 31 26 26 30 10 10 10 10 10 10 10 10 10 10 10 10 10 40 40 40 40 40 40 40 40 40 40 40 40 40 40 40 40 40 40 40 40 40 31 26 26 30 40 40 40 40 40 41 41 41 41 41 
41 41 41 10 10 10 31 26 26 26 32 10 10 10 10 10 10 10 10 10 10 10 10 10 10 10 10 10 10 10 10 10 10 10 10 10 10 10 10 10 10 10 10 10 10 10 10 10 31 26 26 30 10 10 10 10 10 10 10 10 10 10 10 10 10 10 10 10 10 10 10 10 10 10 10 10 10 10 10 10 10 10 10 10 10 10 31 26 26 30 10 10 41 41 41 41 41 41 41 41 
41 41 41 41 10 10 31 26 26 26 26 32 10 10 10 10 10 10 10 10 10 10 10 10 10 10 10 10 10 10 10 10 10 10 10 10 10 10 10 10 10 10 10 10 10 10 10 10 31 26 26 30 10 10 10 10 10 10 10 10 10 10 10 10 10 10 10 10 10 10 10 10 10 10 10 10 10 10 10 10 10 10 10 10 10 10 31 26 26 30 10 10 10 41 41 41 41 41 41 41 
41 41 41 41 10 10 29 28 28 29 26 26 32 33 33 33 33 33 33 33 33 33 33 33 33 33 33 33 33 33 33 33 33 33 33 33 33 33 33 33 33 33 33 33 33 33 33 33 34 26 26 32 33 33 33 33 33 33 33 33 33 33 33 33 33 33 33 33 33 33 33 33 33 33 33 33 33 33 33 33 33 33 33 33 33 33 10 26 26 30 10 10 10 10 41 41 41 41 41 41 
41 41 41 41 41 10 10 10 10 10 29 26 26 26 26 26 26 26 26 26 26 26 26 26 26 26 26 26 26 26 26 26 26 26 26 26 26 26 26 26 26 26 26 26 26 26 26 26 26 26 26 26 26 26 26 26 26 26 26 26 26 26 26 26 26 26 26 26 26 26 26 26 26 26 26 26 26 26 26 26 26 26 26 26 26 26 26 26 26 30 10 10 10 10 41 41 41 41 41 12 
41 41 41 41 41 10 10 10 10 10 10 29 26 26 26 26 26 26 26 26 26 26 26 26 26 26 26 26 26 26 26 26 26 26 26 26 26 26 26 26 26 26 26 26 26 26 26 26 26 26 26 26 26 26 26 26 26 26 26 26 26 26 26 26 26 26 26 26 26 26 26 26 26 26 26 26 26 26 26 26 26 26 26 26 26 26 26 26 26 30 10 10 10 10 10 41 41 41 12 12 
41 41 41 41 41 41 10 10 10 10 10 10 28 28 28 28 28 28 28 28 28 28 28 28 28 28 10 26 26 26 10 28 28 28 28 28 28 28 28 28 28 28 28 28 28 28 28 28 29 26 26 27 28 28 28 28 28 28 28 28 28 28 28 28 28 28 28 28 28 28 28 28 28 28 28 28 28 28 28 28 28 28 28 28 28 28 28 28 28 10 10 10 10 10 10 41 41 12 12 12 
41 41 41 41 41 41 10 10 10 10 10 10 10 10 10 10 10 10 10 10 41 41 41 41 10 41 26 26 26 41 10 10 10 10 10 10 10 10 10 10 10 10 10 10 10 10 10 10 31 26 26 30 10 10 10 10 10 10 10 10 10 10 10 10 10 10 10 10 10 10 10 10 10 10 10 10 10 10 10 10 10 10 10 10 10 10 10 10 10 10 10 10 10 10 10 41 12 12 12 12 
41 41 41 41 41 41 41 10 10 10 10 10 10 10 10 10 10 10 10 41 41 41 41 41 41 35 26 26 41 41 41 10 10 10 10 10 10 10 10 10 10 10 10 10 10 10 10 10 31 26 26 30 10 10 10 10 10 10 10 10 10 10 10 10 10 10 10 10 10 10 10 10 10 10 10 10 10 10 10 10 10 10 10 10 10 10 10 10 10 10 10 10 10 10 10 12 12 12 12 12 
41 41 41 41 41 41 41 41 10 10 10 10 10 10 10 10 10 10 41 41 41 41 41 41 35 26 26 41 41 41 41 41 10 10 10 10 10 10 10 10 10 10 10 10 10 10 10 10 31 26 26 30 10 10 10 10 10 10 10 10 10 10 10 10 10 10 10 10 10 10 10 10 10 10 10 10 10 10 10 10 10 10 10 10 10 10 10 10 10 10 10 10 10 10 10 12 12 12 12 12 
41 41 41 41 41 41 41 41 41 41 10 10 10 10 10 10 10 41 41 41 41 41 41 35 26 26 41 41 41 41 41 41 41 10 10 10 10 10 10 10 10 10 10 10 10 10 10 10 31 26 26 30 10 10 10 10 10 10 10 10 10 10 10 10 10 10 10 10 10 10 10 10 10 10 10 10 10 10 10 10 10 10 10 10 10 10 10 10 10 10 10 10 10 10 10 12 12 12 12 12 
41 41 41 41 41 41 41 41 41 41 41 41 41 41 41 41 41 41 41 41 41 41 41 26 26 26 41 41 41 41 41 41 41 41 10 10 10 10 10 10 10 10 10 10 10 10 10 10 31 26 26 30 10 10 10 10 10 10 10 10 10 10 10 10 10 10 10 10 10 10 10 10 10 10 10 10 10 10 10 10 10 10 10 10 10 10 10 10 10 10 10 10 10 10 10 12 12 12 12 12 
41 41 41 41 41 41 41 41 41 41 41 41 41 41 41 41 41 41 41 41 41 41 41 26 26 26 26 41 41 41 41 41 41 41 10 10 10 10 10 10 10 10 10 10 10 10 10 10 31 26 26 30 10 10 10 10 10 10 10 40 40 40 40 40 40 40 40 40 40 40 40 40 40 40 40 40 40 40 40 40 40 40 40 40 40 40 40 40 40 10 10 10 10 10 10 12 12 12 12 12 
41 41 41 41 41 41 41 41 41 41 41 41 41 41 41 41 41 41 41 41 41 41 41 41 26 26 26 26 41 41 41 41 41 41 10 10 10 10 10 10 10 10 10 10 10 10 10 10 31 26 26 30 10 10 10 10 10 10 10 40 39 39 39 39 39 39 39 39 39 39 39 39 39 39 39 39 39 39 39 39 39 39 39 39 39 39 39 39 40 10 10 10 10 10 10 12 12 12 12 12 
41 41 41 41 41 41 41 41 41 41 41 41 35 33 33 33 33 33 33 33 26 41 41 41 41 26 26 26 26 41 41 41 41 41 41 10 10 10 10 10 10 10 10 10 10 10 10 10 31 26 26 30 10 10 10 10 10 10 10 40 39 39 39 39 39 39 39 39 39 39 39 39 39 39 39 39 39 39 39 39 39 39 39 39 39 39 39 39 40 10 10 10 10 10 10 12 12 12 12 12 
41 41 41 41 41 41 41 41 41 41 26 33 26 26 26 26 26 26 26 26 26 33 26 41 41 41 26 26 26 26 41 41 41 41 41 41 10 10 10 10 10 10 10 10 10 10 10 10 31 26 26 30 10 10 10 10 10 10 10 40 39 39 39 39 39 39 39 39 39 39 39 39 39 39 39 39 39 39 39 39 39 39 39 39 39 39 39 39 40 10 10 10 10 10 10 12 12 12 12 12 
41 41 41 41 41 41 41 41 35 33 26 26 26 26 26 26 26 26 26 26 26 26 26 33 26 41 41 26 26 26 26 41 41 41 41 41 10 10 10 10 10 10 10 10 10 10 10 10 31 26 26 10 33 33 33 33 33 33 10 40 39 39 39 39 39 39 39 39 39 39 39 39 39 39 39 39 39 39 39 39 39 39 39 39 39 39 39 39 40 10 10 10 10 10 10 12 12 12 12 12 
41 41 41 41 41 41 35 33 26 26 26 26 26 26 26 26 26 26 26 26 26 26 26 26 26 26 41 41 26 26 26 26 41 41 41 41 10 10 10 10 10 10 10 10 10 10 10 10 31 26 26 26 26 26 26 26 26 26 26 39 39 39 39 39 39 39 39 39 39 39 39 39 39 39 39 39 39 39 39 39 39 39 39 39 39 39 39 39 40 10 10 10 10 10 10 12 12 12 12 12 
41 41 41 41 41 26 26 26 26 26 26 26 26 26 26 26 26 26 26 26 26 26 26 26 26 26 26 41 41 26 26 26 26 41 41 41 41 10 10 10 10 10 10 10 10 10 10 10 31 26 26 26 26 26 26 26 26 26 26 39 39 39 39 39 39 39 39 39 39 39 39 39 39 39 39 39 39 39 39 39 39 39 39 39 39 39 39 39 40 10 10 10 10 10 10 12 12 12 12 12 
41 41 41 41 41 31 26 26 26 26 26 26 26 26 26 26 26 26 26 26 26 26 26 26 26 26 26 26 41 41 26 26 30 41 41 41 41 10 10 10 10 10 10 10 10 10 10 10 10 28 28 28 28 28 28 28 28 28 10 40 39 39 39 39 39 39 39 39 39 39 39 39 39 39 39 39 39 39 39 39 39 39 39 39 39 39 39 39 40 10 10 10 10 10 10 12 12 12 12 12 
41 41 41 41 41 31 26 26 26 26 26 26 26 26 26 26 26 26 26 26 26 26 26 26 26 26 26 31 41 41 26 26 30 41 41 41 41 10 10 10 10 10 10 10 10 10 10 10 10 10 10 10 10 10 10 10 10 10 10 40 39 39 39 39 39 39 39 39 39 39 39 39 39 39 39 39 39 39 39 39 39 39 39 39 39 39 39 39 40 10 10 10 10 10 10 12 12 12 12 12 
41 41 41 41 41 31 26 26 26 26 26 26 26 26 26 26 26 26 26 26 26 26 26 26 26 26 26 26 33 33 26 26 30 41 41 41 41 41 10 10 10 10 10 10 10 10 10 10 10 10 10 10 10 10 10 10 10 10 10 40 39 39 39 39 39 39 39 39 39 39 39 39 39 39 39 39 39 39 39 39 39 39 39 39 39 39 39 39 40 10 10 10 10 10 12 12 12 12 12 12 
41 41 41 41 41 31 26 26 26 26 26 26 26 26 26 26 26 26 26 26 26 26 26 26 26 26 26 26 26 26 26 26 26 41 41 41 41 41 10 10 10 10 10 10 10 10 10 10 10 10 10 10 10 10 10 10 10 10 10 40 39 39 39 39 39 39 39 39 39 39 39 39 39 39 39 39 39 39 39 39 39 39 39 39 39 39 39 39 40 10 10 10 10 10 12 12 12 12 12 12 
41 41 41 41 41 31 26 26 26 26 26 26 26 26 26 26 26 26 26 26 26 26 26 26 26 26 26 26 28 28 28 26 41 41 41 41 41 41 10 10 10 10 10 10 10 10 10 10 10 10 10 10 10 10 10 10 10 10 10 40 40 40 40 40 40 40 40 40 40 40 40 40 40 40 40 40 40 40 40 40 40 40 40 40 40 40 40 40 40 10 10 10 10 12 12 12 12 12 12 12 
41 41 41 41 41 26 26 26 26 26 26 26 26 26 26 26 26 26 26 26 26 26 26 26 26 26 26 26 41 41 41 41 41 41 41 41 41 12 10 10 10 10 10 10 10 10 10 10 10 10 10 10 10 10 10 10 10 10 10 10 10 10 10 10 10 10 10 10 10 10 10 10 10 10 10 10 10 10 10 10 10 10 10 10 10 10 10 10 10 10 10 10 10 12 12 12 12 12 12 12 
41 41 41 41 41 41 26 28 26 26 26 26 26 26 26 26 26 26 26 26 26 26 26 26 26 28 26 41 41 41 41 41 41 41 41 41 41 12 12 10 10 10 10 10 10 10 10 10 10 10 10 10 10 10 10 10 10 10 10 10 10 10 10 10 10 10 10 10 10 10 10 10 10 10 10 10 10 10 10 10 10 10 10 10 10 10 10 10 10 10 10 10 12 12 12 12 12 12 12 12 
41 41 41 41 41 41 41 41 26 28 26 26 26 26 26 26 26 26 26 26 26 26 26 28 26 41 41 41 41 41 41 41 41 41 41 41 41 12 12 10 10 10 10 10 10 10 10 10 10 10 10 10 10 10 10 10 10 10 10 10 10 10 10 10 10 10 10 10 10 10 10 10 10 10 10 10 10 10 10 10 10 10 10 10 10 10 10 10 10 10 10 12 12 12 12 12 12 12 12 12 
41 41 41 41 41 41 41 41 41 41 26 28 26 26 26 26 26 26 26 26 26 28 26 41 41 41 41 41 41 41 41 41 41 41 41 41 12 12 12 12 10 10 10 10 10 10 10 10 10 10 10 10 10 10 10 10 10 10 10 10 10 10 10 10 10 10 10 10 10 10 10 10 10 10 10 10 10 10 10 10 10 10 10 10 10 10 10 10 10 12 12 12 12 12 12 12 12 12 12 12 
41 41 41 41 41 41 41 41 41 41 41 41 26 28 28 28 28 28 28 28 26 41 41 41 41 41 41 41 41 41 41 41 41 41 41 41 12 12 12 12 12 12 12 12 12 12 12 12 12 12 12 12 12 12 12 12 12 12 12 12 12 12 12 12 12 12 12 12 12 12 12 12 12 12 12 12 12 12 12 12 12 12 12 12 12 12 12 12 12 12 12 12 12 12 12 12 12 12 12 12 
41 41 41 41 41 41 41 41 41 41 41 41 41 41 41 41 41 41 41 41 41 41 41 41 41 41 41 41 41 41 41 41 41 41 41 41 12 12 12 12 12 12 12 12 12 12 12 12 12 12 12 12 12 12 12 12 12 12 12 12 12 12 12 12 12 12 12 12 12 12 12 12 12 12 12 12 12 12 12 12 12 12 12 12 12 12 12 12 12 12 12 12 12 12 12 12 12 12 12 12 
41 41 41 41 41 41 41 41 41 41 41 41 41 41 41 41 41 41 41 41 41 41 41 41 41 41 41 41 41 41 41 41 41 41 41 12 12 12 12 12 12 12 12 12 12 12 12 12 12 12 12 12 12 12 12 12 12 12 12 12 12 12 12 12 12 12 12 12 12 12 12 12 12 12 12 12 12 12 12 12 12 12 12 12 12 12 12 12 12 12 12 12 12 12 12 12 12 12 12 12 
41 41 41 41 41 41 41 41 41 41 41 41 41 41 41 41 41 41 41 41 41 41 41 41 41 41 41 41 41 41 41 41 41 12 12 12 12 12 12 12 12 12 12 12 12 12 12 12 12 12 12 12 12 12 12 12 12 12 12 12 12 12 12 12 12 12 12 12 12 12 12 12 12 12 12 12 12 12 12 12 12 12 12 12 12 12 12 12 12 12 12 12 12 12 12 12 12 12 12 12 