41 41 41 41 41 41 41 41 41 41 41 41 41 41 41 41 41 41 41 41 41 41 41 41 41 41 41 41 41 41 41 41 41 41 41 41 41 41 41 41 41 41 41 41 41 41 41 41 41 41 41 41 41 41 41 41 41 41 41 41 41 41 41 41 41 41 41 41 41 41 41 41 41 41 41 41 41 41 41 41 41 41 41 41 41 41 41 41 41 41 41 41 41 41 41 41 41 41 41 41 
41 41 41 41 41 41 41 41 41 41 41 41 41 41 41 41 41 41 41 41 41 41 41 41 41 41 41 41 41 41 41 41 41 41 41 41 41 41 41 41 41 41 41 41 41 41 41 41 41 41 41 41 41 41 41 41 41 41 41 41 41 41 41 41 41 41 41 41 41 41 41 41 41 41 41 41 41 41 41 41 41 41 41 41 41 41 41 41 41 41 41 41 41 41 41 41 41 41 41 41 
41 41 41 41 41 10 10 10 10 10 10 11 10 10 10 10 10 10 11 10 10 10 10 10 10 11 10 41 41 41 41 41 41 41 41 41 41 41 41 41 40 40 40 40 40 40 40 40 40 40 40 40 40 40 40 40 40 40 40 40 41 41 41 41 41 40 40 40 40 40 40 40 40 40 40 40 40 40 40 40 40 40 40 40 40 40 40 40 40 40 40 40 40 40 40 41 41 41 41 41 
41 41 41 41 10 10 10 10 10 10 10 10 10 10 11 10 10 10 10 10 10 10 11 10 10 10 10 10 41 41 41 41 41 41 41 41 41 41 41 41 40 39 39 39 39 39 39 39 39 39 39 39 39 39 39 39 39 39 39 40 41 41 41 41 41 40 11 10 10 10 10 10 11 10 10 10 10 10 10 10 11 10 10 10 10 11 10 10 10 10 11 10 10 11 40 41 41 41 41 41 
41 41 41 10 10 10 11 10 10 10 10 10 10 10 10 10 10 10 10 10 10 10 10 10 10 10 10 10 10 41 41 41 41 41 41 41 41 41 41 41 40 39 39 39 39 39 39 39 39 39 39 39 39 39 39 39 39 39 39 40 41 41 41 41 41 40 10 10 42 10 10 42 10 10 42 10 10 42 10 10 42 10 10 42 10 10 42 10 10 42 10 10 42 10 40 41 41 41 41 41 
41 41 41 10 11 10 10 10 14 15 15 15 15 15 15 15 15 15 15 15 15 15 16 10 10 10 11 10 10 41 41 41 41 41 41 41 41 41 41 41 40 39 39 39 39 39 39 39 39 39 39 39 39 39 39 39 39 39 39 40 41 41 41 41 41 40 10 10 10 35 33 33 33 33 33 33 33 33 33 33 33 33 33 33 33 33 33 33 33 36 10 10 10 10 40 41 41 41 41 41 
41 41 41 10 10 10 11 14 25 12 12 12 12 12 12 12 12 12 12 12 12 12 24 16 10 10 10 10 10 41 41 41 41 41 41 41 41 41 41 41 40 39 39 39 39 39 39 39 39 39 39 39 39 39 39 39 39 39 39 40 41 41 41 41 41 40 10 42 10 31 26 26 26 26 26 26 26 26 26 26 26 26 26 26 26 26 26 26 26 30 10 42 10 10 40 41 41 41 41 41 
41 41 41 10 10 10 14 25 12 12 13 12 12 12 13 12 12 13 12 13 12 12 12 24 16 10 10 10 10 41 41 41 41 41 41 41 41 41 41 41 40 39 39 39 39 39 39 39 39 39 39 39 39 39 39 39 39 39 39 40 41 41 41 41 41 40 10 10 10 31 26 26 26 26 26 26 26 26 26 26 26 26 26 26 26 26 26 26 26 30 11 10 10 10 40 41 41 41 41 41 
41 41 41 11 10 10 17 12 12 12 12 12 12 12 12 12 12 12 12 12 12 12 12 12 24 16 11 10 10 11 41 41 41 41 41 41 41 41 41 41 40 39 39 39 39 39 39 39 39 39 39 39 39 39 39 39 39 39 39 40 41 41 41 41 41 40 10 10 42 31 26 26 27 28 28 28 28 28 28 28 28 28 28 28 28 28 29 26 26 30 10 10 42 10 40 41 41 41 41 41 
41 41 41 10 10 10 17 12 12 12 12 12 12 12 12 12 12 12 12 12 12 13 12 12 12 18 10 10 10 10 10 10 10 10 41 41 41 41 41 41 40 39 39 39 39 39 39 39 39 39 39 39 39 39 39 39 39 39 39 40 41 41 41 41 41 40 11 10 10 31 26 26 30 10 42 10 10 42 10 10 42 10 10 42 10 10 31 26 26 30 10 10 10 11 40 41 41 41 41 41 
41 41 41 10 10 10 17 12 12 12 12 12 13 12 12 12 13 12 12 12 12 12 12 12 12 18 10 10 11 10 11 10 10 10 10 41 41 41 41 41 40 39 39 39 39 39 39 39 39 39 39 39 39 39 39 39 39 39 39 40 41 41 41 41 41 40 10 35 33 34 26 26 32 33 36 10 10 10 10 11 10 10 11 10 10 10 31 26 26 30 10 42 10 10 40 41 41 41 41 41 
41 41 41 10 11 10 17 12 13 12 12 12 12 12 12 12 12 12 12 12 12 12 12 12 12 24 16 10 10 10 10 10 10 11 10 10 41 10 41 41 40 39 39 39 39 39 39 39 39 39 39 39 39 39 39 39 39 39 39 40 41 41 10 41 41 40 10 31 26 26 26 26 26 26 30 10 10 10 10 10 10 11 10 10 10 10 31 26 26 30 10 10 10 10 40 41 41 41 41 41 
41 41 41 10 10 10 19 23 12 12 12 12 12 12 12 12 12 12 12 12 13 12 12 12 13 12 24 15 15 15 16 10 10 10 10 10 10 41 41 41 40 39 39 39 39 39 39 39 39 39 39 39 39 39 39 39 39 39 39 40 41 10 10 10 41 40 10 31 26 26 26 26 26 26 30 10 10 42 10 10 42 10 10 42 10 10 31 26 26 30 10 11 42 10 40 41 41 41 41 41 
41 41 41 10 10 10 10 19 23 12 12 12 13 12 12 13 12 12 12 12 12 12 12 12 12 12 12 12 12 12 24 16 10 10 10 10 10 10 41 41 40 39 39 39 39 39 39 39 39 39 39 39 39 39 39 39 39 39 39 40 41 11 10 10 41 40 11 31 26 26 26 26 26 26 30 10 10 10 10 11 10 10 10 10 11 10 31 26 26 30 10 10 10 10 40 41 41 41 41 41 
41 41 41 10 10 10 11 10 19 20 20 20 23 12 12 12 12 13 12 12 12 12 12 12 13 12 12 12 12 13 12 18 10 11 10 10 10 10 10 41 40 39 39 39 39 39 39 39 39 39 39 39 39 39 39 39 39 39 39 40 10 10 10 10 10 40 10 31 26 26 26 26 26 26 30 10 10 10 10 10 10 10 11 10 10 10 31 26 26 30 10 42 10 10 40 41 41 41 41 41 
41 41 41 10 10 10 10 10 10 11 10 10 17 12 12 12 12 12 12 12 12 13 12 12 12 12 12 13 12 12 12 18 10 10 10 10 11 10 10 10 40 40 40 40 40 40 40 40 40 39 39 40 40 40 40 40 40 40 40 40 10 10 10 10 10 40 11 31 26 26 26 26 26 26 30 11 10 42 10 10 42 10 10 42 10 10 31 26 26 30 10 10 10 10 40 41 41 41 41 41 
41 41 41 10 11 10 10 10 10 10 10 10 19 20 20 23 12 12 12 12 12 12 12 12 12 12 12 12 12 12 22 21 10 10 10 10 10 10 10 10 10 10 10 10 10 10 10 10 31 26 26 30 10 10 10 10 10 10 10 10 10 10 11 10 10 40 10 37 28 28 28 28 28 28 38 10 10 10 10 11 10 10 10 10 10 10 31 26 26 30 10 10 42 10 40 41 41 41 41 41 
41 41 41 10 10 10 35 33 33 33 36 11 10 10 10 19 20 20 20 20 20 20 20 20 20 20 20 20 20 20 21 10 10 11 10 10 10 10 10 10 10 11 10 10 10 10 10 10 31 26 26 30 10 10 11 10 10 10 10 11 10 10 10 10 10 40 10 10 10 11 10 10 11 10 10 10 10 11 10 10 10 10 10 10 11 10 31 26 26 30 10 10 10 10 40 41 41 41 41 41 
41 41 41 10 10 10 31 26 26 26 30 10 10 10 10 11 10 10 10 11 10 10 10 10 11 10 10 10 10 10 11 10 10 10 10 10 11 10 10 10 10 10 10 10 10 10 10 10 31 26 26 30 10 10 10 10 10 10 10 10 10 10 10 10 10 40 40 40 40 40 40 40 40 40 40 40 40 40 40 40 40 40 40 40 40 40 31 26 26 30 40 40 40 40 40 41 41 41 41 41 
41 41 41 10 10 10 31 26 26 26 32 36 11 10 10 10 10 11 10 10 10 10 10 11 10 10 10 10 11 10 10 10 10 10 11 10 10 10 10 10 11 10 10 10 10 11 10 10 31 26 26 30 10 10 10 11 10 10 10 10 11 10 10 10 10 11 10 10 11 10 10 10 11 10 10 10 10 10 10 11 10 10 10 10 10 11 31 26 26 30 10 10 41 41 41 41 41 41 41 41 
41 41 41 41 11 10 31 26 26 26 26 32 36 11 10 10 10 10 10 10 11 10 10 10 10 10 10 10 10 10 10 10 10 10 10 10 10 10 10 10 10 10 10 10 10 10 10 10 31 26 26 30 10 10 10 10 10 10 10 10 10 10 10 10 10 10 10 10 10 10 10 11 10 10 10 11 10 10 10 10 10 11 10 11 10 10 31 26 26 30 10 10 10 41 41 41 41 41 41 41 
41 41 41 41 10 10 37 28 28 29 26 26 32 33 33 33 33 33 33 33 33 33 33 33 33 33 33 33 33 33 33 33 33 33 33 33 33 33 33 33 33 33 33 33 33 33 33 33 34 26 26 32 33 33 33 33 33 33 33 33 33 33 33 33 33 33 33 33 33 33 33 33 33 33 33 33 33 33 33 33 33 33 33 33 33 33 34 26 26 30 10 11 10 10 41 41 41 41 14 15 
41 41 41 41 41 10 10 10 10 37 29 26 26 26 26 26 26 26 26 26 26 26 26 26 26 26 26 26 26 26 26 26 26 26 26 26 26 26 26 26 26 26 26 26 26 26 26 26 26 26 26 26 26 26 26 26 26 26 26 26 26 26 26 26 26 26 26 26 26 26 26 26 26 26 26 26 26 26 26 26 26 26 26 26 26 26 26 26 26 30 10 10 10 10 41 41 41 14 25 12 
41 41 41 41 41 10 10 11 10 10 37 29 26 26 26 26 26 26 26 26 26 26 26 26 26 26 26 26 26 26 26 26 26 26 26 26 26 26 26 26 26 26 26 26 26 26 26 26 26 26 26 26 26 26 26 26 26 26 26 26 26 26 26 26 26 26 26 26 26 26 26 26 26 26 26 26 26 26 26 26 26 26 26 26 26 26 26 26 26 30 10 10 10 10 10 41 14 25 12 12 
41 41 41 41 41 41 10 10 10 10 10 37 28 28 28 28 28 28 28 28 28 28 29 26 26 26 26 26 27 28 28 28 28 28 28 28 28 28 28 28 28 28 28 28 28 28 28 28 29 26 26 27 28 28 28 28 28 28 28 28 28 28 28 28 28 28 28 28 28 28 28 28 28 28 28 28 28 28 28 28 28 28 28 28 28 28 28 28 28 38 11 10 10 10 10 14 25 12 12 12 
41 41 41 41 41 41 10 10 11 10 10 10 10 10 10 10 10 10 10 10 41 41 37 29 26 26 26 27 38 41 10 10 10 10 10 11 10 10 10 10 10 11 10 10 10 10 10 10 31 26 26 30 10 10 10 10 10 11 10 10 10 10 10 11 10 10 10 10 10 10 10 10 10 10 10 10 10 10 10 11 10 11 10 10 10 10 10 10 10 10 10 10 10 11 14 25 12 13 12 13 
41 41 41 41 41 41 41 10 10 10 10 11 10 10 10 10 11 10 10 41 41 41 41 37 29 26 27 38 41 41 41 10 11 10 10 10 10 11 10 10 10 10 10 10 11 10 10 10 31 26 26 30 10 10 11 10 10 10 10 11 10 10 10 10 10 10 10 10 11 10 10 10 10 10 11 10 10 10 10 10 10 10 10 10 11 10 10 10 10 11 10 10 10 10 17 12 12 12 12 12 
41 41 41 41 41 41 41 41 10 11 10 10 10 10 11 10 10 10 41 41 41 41 41 41 31 26 30 41 41 41 41 41 10 10 10 11 10 10 10 10 10 10 10 10 10 10 10 10 31 26 26 30 10 10 10 10 10 10 10 10 10 10 11 10 10 10 10 10 10 10 10 10 10 10 10 10 11 10 10 10 10 10 10 10 10 10 10 10 10 10 10 10 10 10 17 12 12 12 12 12 
41 41 41 41 41 41 41 41 41 41 10 10 10 10 10 10 10 41 41 41 41 41 41 41 31 26 30 41 41 41 41 41 41 10 10 10 10 10 10 10 11 10 10 11 10 10 10 10 31 26 26 30 11 10 10 10 10 10 10 10 10 10 10 10 10 10 10 11 10 10 10 11 10 10 10 10 10 10 10 10 10 10 10 10 10 10 11 10 10 10 10 10 11 10 17 12 12 12 12 12 
41 41 41 41 41 41 41 41 41 41 41 41 41 41 41 41 41 41 41 41 41 41 41 41 31 26 30 41 41 41 41 41 41 41 10 10 10 10 10 10 10 10 10 10 10 10 10 10 31 26 26 30 10 10 10 10 11 10 10 10 10 10 10 11 10 10 10 10 10 10 10 10 10 10 10 10 10 10 10 11 10 10 10 10 10 10 10 10 10 10 10 10 10 10 17 12 13 12 12 12 
41 41 41 41 41 41 41 41 41 41 41 41 41 41 41 41 41 41 41 41 41 41 41 41 31 26 32 36 41 41 41 41 41 41 10 10 10 10 10 10 10 10 10 10 10 10 10 10 31 26 26 30 10 10 11 10 10 10 10 40 40 40 40 40 40 40 40 40 40 40 40 40 40 40 40 40 40 40 40 40 40 40 40 40 40 40 40 40 40 10 10 10 10 10 17 12 12 12 12 12 
41 41 41 41 41 41 41 41 41 41 41 41 41 41 41 41 41 41 41 41 41 41 41 41 37 29 26 32 36 41 41 41 41 41 10 10 10 10 10 10 10 10 11 10 10 10 10 10 31 26 26 30 10 10 10 10 10 10 10 40 39 39 39 39 39 39 39 39 39 39 39 39 39 39 39 39 39 39 39 39 39 39 39 39 39 39 39 39 40 10 10 11 10 10 17 12 12 12 12 12 
41 41 41 41 41 41 41 41 41 41 41 41 35 33 33 33 33 33 33 33 36 41 41 41 41 37 29 26 32 36 41 41 41 41 41 10 10 11 10 10 10 10 10 10 10 10 10 10 31 26 26 30 10 11 10 10 10 11 10 40 39 39 39 39 39 39 39 39 39 39 39 39 39 39 39 39 39 39 39 39 39 39 39 39 39 39 39 39 40 10 10 10 10 10 17 12 12 12 12 13 
41 41 41 41 41 41 41 41 41 41 35 33 34 26 26 26 26 26 26 26 32 33 36 41 41 41 37 29 26 32 36 41 41 41 41 41 10 10 10 10 11 10 10 10 10 10 11 10 31 26 26 30 10 10 10 10 10 10 10 40 39 39 39 39 39 39 39 39 39 39 39 39 39 39 39 39 39 39 39 39 39 39 39 39 39 39 39 39 40 11 10 10 10 10 17 12 12 13 12 12 
41 41 41 41 41 41 41 41 35 33 34 26 26 26 26 26 26 26 26 26 26 26 32 33 36 41 41 37 29 26 32 36 41 41 41 41 10 10 10 10 10 10 10 11 10 11 10 10 31 26 26 32 33 33 33 33 33 33 33 40 39 39 39 39 39 39 39 39 39 39 39 39 39 39 39 39 39 39 39 39 39 39 39 39 39 39 39 39 40 10 10 10 10 10 17 12 13 12 12 12 
41 41 41 41 41 41 35 33 34 26 26 26 26 26 26 26 26 26 26 26 26 26 26 26 32 36 41 41 37 29 26 32 36 41 41 41 10 10 10 10 10 10 10 10 10 10 10 10 31 26 26 26 26 26 26 26 26 26 26 39 39 39 39 39 39 39 39 39 39 39 39 39 39 39 39 39 39 39 39 39 39 39 39 39 39 39 39 39 40 10 10 10 10 10 17 12 12 12 12 12 
41 41 41 41 41 35 34 26 26 26 26 26 26 26 26 26 26 26 26 26 26 26 26 26 26 32 36 41 41 37 29 26 32 36 41 41 41 10 10 10 10 11 10 10 10 10 10 10 31 26 26 26 26 26 26 26 26 26 26 39 39 39 39 39 39 39 39 39 39 39 39 39 39 39 39 39 39 39 39 39 39 39 39 39 39 39 39 39 40 10 11 10 10 10 17 12 12 12 13 12 
41 41 41 41 41 31 26 26 26 26 26 26 26 26 26 26 26 26 26 26 26 26 26 26 26 26 32 36 41 41 31 26 26 30 41 41 41 10 10 10 10 10 10 10 10 10 10 10 37 28 28 28 28 28 28 28 28 28 28 40 39 39 39 39 39 39 39 39 39 39 39 39 39 39 39 39 39 39 39 39 39 39 39 39 39 39 39 39 40 10 10 10 11 10 17 12 12 12 12 12 
41 41 41 41 41 31 26 26 26 26 26 26 26 26 26 26 26 26 26 26 26 26 26 26 26 26 26 30 41 41 31 26 26 30 41 41 41 10 10 11 10 10 10 10 10 10 10 10 10 10 10 10 10 10 10 10 10 10 10 40 39 39 39 39 39 39 39 39 39 39 39 39 39 39 39 39 39 39 39 39 39 39 39 39 39 39 39 39 40 10 10 10 10 14 25 12 12 12 12 12 
41 41 41 41 41 31 26 26 26 26 26 26 26 26 26 26 26 26 26 26 26 26 26 26 26 26 26 32 33 33 34 26 26 30 41 41 41 41 10 10 10 10 11 10 10 10 10 10 10 10 10 10 10 10 10 10 10 11 10 40 39 39 39 39 39 39 39 39 39 39 39 39 39 39 39 39 39 39 39 39 39 39 39 39 39 39 39 39 40 10 10 10 10 17 12 12 12 12 12 13 
41 41 41 41 41 31 26 26 26 26 26 26 26 26 26 26 26 26 26 26 26 26 26 26 26 26 26 26 26 26 26 26 26 30 41 41 41 41 10 10 10 10 10 10 10 11 10 10 10 10 10 11 10 10 10 10 10 10 10 40 39 39 39 39 39 39 39 39 39 39 39 39 39 39 39 39 39 39 39 39 39 39 39 39 39 39 39 39 40 10 10 10 14 25 12 12 13 12 12 12 
41 41 41 41 41 31 26 26 26 26 26 26 26 26 26 26 26 26 26 26 26 26 26 26 26 26 26 27 28 28 28 28 28 38 41 41 14 15 16 10 10 11 10 10 10 10 10 10 10 10 10 10 10 10 10 10 10 10 10 40 40 40 40 40 40 40 40 40 40 40 40 40 40 40 40 40 40 40 40 40 40 40 40 40 40 40 40 40 40 10 11 10 17 12 12 12 12 12 12 12 
41 41 41 41 41 37 29 26 26 26 26 26 26 26 26 26 26 26 26 26 26 26 26 26 26 26 27 38 41 41 41 41 41 41 41 41 17 12 24 16 10 10 10 10 10 10 10 10 11 10 10 10 10 10 10 10 11 10 10 10 10 10 10 10 10 10 10 10 10 10 10 10 10 11 10 10 10 10 10 10 10 10 10 10 11 10 10 10 10 10 10 14 25 12 12 12 12 13 12 12 
41 41 41 41 41 41 37 28 29 26 26 26 26 26 26 26 26 26 26 26 26 26 26 26 27 28 38 41 41 41 41 41 41 41 41 41 17 13 12 18 10 10 10 11 10 10 10 10 10 10 10 11 10 10 10 10 10 10 10 10 11 10 10 10 11 10 10 10 10 10 10 10 10 10 10 10 10 11 10 10 10 10 10 10 10 10 10 11 10 10 14 25 12 12 12 12 12 12 12 12 
41 41 41 41 41 41 41 41 37 28 29 26 26 26 26 26 26 26 26 26 26 26 27 28 38 41 41 41 41 41 41 41 41 41 41 14 25 12 12 24 16 10 10 10 10 10 10 10 10 10 10 10 10 10 10 10 10 10 10 10 10 10 10 10 10 10 10 10 11 10 10 10 11 10 10 10 10 10 10 10 10 11 10 10 10 10 10 10 14 15 25 12 12 12 13 12 12 12 13 12 
41 41 41 41 41 41 41 41 41 41 37 28 29 26 26 26 26 26 26 26 27 28 38 41 41 41 41 41 41 41 41 41 41 41 41 17 12 12 12 12 24 15 15 15 15 15 15 15 16 10 10 10 10 10 10 11 10 10 10 10 10 10 14 15 15 15 15 15 15 15 15 15 15 16 10 10 10 10 10 10 10 10 10 10 10 11 14 15 25 12 12 12 12 12 12 12 12 12 12 12 
41 41 41 41 41 41 41 41 41 41 41 41 37 28 28 28 28 28 28 28 38 41 41 41 41 41 41 41 41 41 41 41 41 41 41 17 12 13 12 12 12 12 12 13 12 12 12 12 24 15 15 15 15 15 15 15 15 15 15 15 15 15 25 12 12 12 12 13 12 12 12 12 12 24 15 15 15 15 15 15 15 15 15 15 15 15 25 12 12 12 12 13 12 12 12 12 12 12 12 12 
41 41 41 41 41 41 41 41 41 41 41 41 41 41 41 41 41 41 41 41 41 41 41 41 41 41 41 41 41 41 41 41 41 41 14 25 12 12 12 13 12 12 12 12 12 12 12 12 12 13 12 12 12 12 12 12 13 12 12 12 12 13 12 13 12 12 12 12 12 12 13 12 12 12 12 12 13 12 12 12 12 12 12 12 12 12 12 12 12 13 12 12 12 12 12 12 13 12 13 12 
41 41 41 41 41 41 41 41 41 41 41 41 41 41 41 41 41 41 41 41 41 41 41 41 41 41 41 41 41 41 41 41 14 15 25 12 12 12 12 12 12 12 13 12 12 12 13 12 12 12 12 12 13 12 12 12 12 12 13 12 12 12 12 12 12 13 12 12 12 12 12 12 12 13 12 12 12 12 12 12 12 12 13 12 12 13 12 12 12 12 12 12 12 12 12 12 12 12 12 12 
41 41 41 41 41 41 41 41 41 41 41 41 41 41 41 41 41 41 41 41 41 41 41 41 41 41 41 41 41 41 41 41 17 12 12 13 12 12 12 12 12 12 12 12 12 12 12 12 12 12 12 12 12 12 12 13 12 12 12 12 12 12 12 12 12 12 12 12 12 12 12 12 12 12 12 12 12 12 12 13 12 12 12 12 12 12 12 12 13 12 12 12 12 13 12 12 12 12 12 12 